---
1111111111
1111111111
1111111111
1111111111
1111111111
1111111111
1111111111
1111111111
1111111111
1111111111
---
1111111111
1001111001
1001101111
1111101111
1110000001
1011101111
1111111101
1101000101
1101100001
1111111111
---
1111111111
1001111111
1101101111
1101111111
1111111111
1011101111
1001111101
1111111111
1011101101
1111111111
---
1111111111
1111101111
1111101111
1100001111
1111001111
1011100011
1110101111
1110001111
1111101111
1111111111
---
1111111111
1011111101
1011111111
1111101111
1111111111
1011110011
1111001111
1111100111
1111110001
1111111111
---
1111111111
1111110111
1000010011
1011111001
1011111111
1011110011
1101100111
1100110111
1110010111
1111111111
---
1111111111
1111111111
1111111111
1111111111
1111111011
1000111011
1110010011
1111011111
1111010111
1111111111
---
1111111111
1110111111
1110111111
1000111101
1000000001
1100111001
1010111001
1111111111
1111111111
1111111111
---
1111111111
1111011111
1111011111
1111000011
1011110001
1101111001
1001111001
1100111111
1110001111
1111111111
---
1111111111
1111111111
1111111111
1111111111
1111111111
1111111111
1111111111
1111111111
1111111111
1111111111
