---
111111
111111
111111
111111
111111
111111
---
111111
110111
100111
100001
100001
111111
---
111111
101111
100101
111111
101001
111111
---
111111
101111
100001
111111
101111
111111
---
111111
111111
101111
111111
101001
111111
---
111111
111111
111111
111111
111111
111111
