---
11111111111111
10009090909001
10000900090001
10000000000001
10090000090001
10000000000001
10000000000001
10090000090001
10000000000001
10000000000001
10000000000001
10000000000001
10000000000001
11111111111111
---
11111111111111
11111111111111
11111111111111
11011111111111
11011111111111
11111100001111
11111101111111
11111101111111
11111101110111
11111111111111
11111111111111
11111111111111
11110111111111
11111111111111
---
11111111111111
11111111111111
11001111111111
11100001111111
10011111111111
11111111101111
11101111111111
11101101111111
11101101110111
11100111110111
11111111110111
11111111111111
11110111111111
11111111111111
---
11111111111111
11111111111111
11111111111111
11011111110111
10111111110111
11111111100111
11111111111111
11111101111111
11111111111111
11111111100111
11111111110111
11111111111111
11111111111111
11111111111111
---
11111111111111
11111111111111
11111111011111
11011111011111
10111111110111
11111111110111
11111111111111
11111111111111
11111111111111
11111111110111
11111111110111
11111111111111
11111111111111
11111111111111
---
11111111111111
11111111011111
11111111011111
11011100011111
10111111111111
11111111110111
11111111111111
11111111111111
11111111111111
11111111110111
11111111111111
11111100011011
11111111011111
11111111111111
---
11111111111111
11111111111111
11111111111111
11011110011111
10111111111111
10111111111111
11111111111111
11111111111111
11100011111111
10111011110111
10111011111111
11111111111011
11000111111111
11111111111111
---
11111111111111
11111111111111
11111111111111
11011110111111
11111111111111
11111111111111
11111111111111
11111111111111
11111111111111
11111111110111
10111111111111
11111111111011
11110111111111
11111111111111
---
11111111111111
11111111111111
11111111111111
11110110011111
11111111111111
11111111111111
11111100111111
11111110111111
11111110111111
11111111110111
10111111111111
11111111111001
11111111111111
11111111111111
---
11111111111111
11111110111111
11001110111111
11100000001111
11111010111111
11111010111111
11111110110111
11111110001111
11111111100111
11111111111111
10111111111111
11111111111101
11111110111111
11111111111111
---
11111111111111
11111111111111
11011111111111
11011111100111
11111111111111
11111110111111
11111111110001
11111111111111
11111111011111
11111111001111
10110110000001
10110111100001
11110111111111
11111111111111
---
11111111111111
11111111111111
11111111111111
11011111111111
11111111111111
11111101111111
11111111111111
11110111111111
11111111111111
11111111011111
11111111111111
11111111111111
11110111111111
11111111111111
---
11111111111111
11111111111111
11111111111111
11011111111111
11111111111111
11111100111111
11111111111111
11110001111111
11111101110111
11111100011111
11111110111111
11111111111111
11110111111111
11111111111111
---
11111111111111
11111111111111
11111111111111
11111111111111
11111111111111
11111111111111
11111111111111
11111111111111
11111111111111
11111111111111
11111111111111
11111111111111
11111111111111
11111111111111
