---
111111
100001
100001
100001
100001
111111
---
111111
101101
111111
111111
111111
111111
---
111111
110111
110111
100111
111111
111111
---
111111
111111
111101
100101
100111
111111
---
111111
100001
111111
110111
101111
111111
---
111111
111111
111111
111111
111111
111111
