---
1111111111
1000000001
1000000001
1000099001
1090000001
1000000001
1000009001
1000000001
1000000001
1111111111
---
1111111111
1111111111
1111111111
1111111111
1111111111
1111111111
1111111111
1111111011
1111111111
1111111111
---
1111111111
1111111111
1111111111
1111111111
1111111111
1111111111
1111100111
1111110011
1111111111
1111111111
---
1111111111
1111111101
1111111101
1111111101
1111111111
1111111101
1111111101
1111111111
1111110001
1111111111
---
1111111111
1111111111
1111111111
1111111111
1111111111
1111111111
1111111101
1111111111
1111111111
1111111111
---
1111111111
1111111111
1111111111
1111111111
1111111111
1111111111
1111111101
1111111001
1111111111
1111111111
---
1111111111
1111111011
1111111011
1111111111
1111111111
1111111111
1111111111
1111111011
1111111011
1111111111
---
1111111111
1111111111
1111111011
1111111111
1111111111
1111111111
1111111111
1111111111
1111111111
1111111111
---
1111111111
1111111111
1111111011
1111111011
1111111011
1111111011
1111111011
1111111011
1111111111
1111111111
---
1111111111
1111111111
1111111111
1111111111
1111111111
1111111111
1111111111
1111111111
1111111111
1111111111
